0000000000000000000000000000000000000000000000000000000000000000000000000000000000000000000000000000000000000000000000000000
0000000000000000000000000000000000000000000000000000000000000000000000000000000000000000000000000000000000000000000000000000
0000000000000000000000000000000000000000000000000000000000000000000000000000000000000000000000000000000000000000000000000000
0000000000000000000000000000000000000000000000000000000000000000000000000000000000000000000000000000000000000000000000000000
0000111100001111000011110000111100001111000011110000111100001111000011110000111100001111000011110000000000000000000000000000
0000111100001111000011110000111100001111000011110000111100001111000011110000111100001111000011110000000000000000000000000000
0000111100001111000011110000111100001111000011110000111100001111000011110000111100001111000011110000000000000000000000000000
0000111100001111000011110000111100001111000011110000111100001111000011110000111100001111000011110000000000000000000000000000
0000111100001111000011110000111100001111000011110000111100001111000011110000111100001111000011110000000000000000000000000000
0000111100001111000011110000111100001111000011110000111100001111000011110000111100001111000011110000000000000000000000000000
0000111100001111000011110000111100001111000011110000111100001111000011110000111100001111000011110000000000000000000000000000
0000111100001111000011110000111100001111000011110000111100001111000011110000111100001111000011110000000000000000000000000000
0000111100001111000011110000111100001111000011110000111100001111000011110000111100001111000011110000000000000000000000000000
0000111100001111000011110000111100001111000011110000111100001111000011110000111100001111000011110000000000000000000000000000
0000111100001111000011110000111100001111000011110000111100001111000011110000111100001111000011110000000000000000000000000000
0000111100001111000011110000111100001111000011110000111100001111000011110000111100001111000011110000000000000000000000000000
0000111100001111000011110000111100001111000011110000111100001111000011110000111100001111000011110000000000000000000000000000
0000111100001111000011110000111100001111000011110000111100001111000011110000111100001111000011110000000000000000000000000000
0000111100001111000011110000111100001111000011110000111100001111000011110000111100001111000011110000111100001111000011110000
0000111100001111000011110000111100001111000011110000111100001111000011110000111100001111000011110000111100001111000011110000
0000111100001111000011110000111100001111000011110000111100001111000011110000111100001111000011110000111100001111000011110000
0000111100001111000011110000111100001111000011110000111100001111000011110000111100001111000011110000111100001111000011110000
0000111100001111000011110000111100001111000011110000111100001111000011110000111100001111000011110000111100001111000011110000
0000111100001111000011110000111100001111000011110000111100001111000011110000111100001111000011110000111100001111000011110000
0000111100001111000011110000111100001111000011110000111100001111000011110000111100001111000011110000111100001111000011110000
0000111100001111000011110000111100001111000011110000111100001111000011110000111100001111000011110000111100001111000011110000
0000111100001111000011110000111100001111000011110000111100001111000011110000111100001111000011110000111100001111000011110000
0000111100001111000011110000111100001111000011110000111100001111000011110000111100001111000011110000111100001111000011110000
0000111100001111000011110000111100001111000011110000111100001111000011110000111100001111000011110000111100001111000011110000
0000111100001111000011110000111100001111000011110000111100001111000011110000111100001111000011110000111100001111000011110000
0000111100001111000011110000111100001111000011110000111100001111000011110000111100001111000011110000111100001111000011110000
0000111100001111000011110000111100001111000011110000111100001111000011110000111100001111000011110000111100001111000011110000
0000000000000000000000000000000000000000000000000000000000000000000000000000000000000000000000000000000000000000000000000000
0000000000000000000000000000000000000000000000000000000000000000000000000000000000000000000000000000000000000000000000000000
0000000000000000000000000000000000000000000000000000000000000000000000000000000000000000000000000000000000000000000000000000
0000000000000000000000000000000000000000000000000000000000000000000000000000000000000000000000000000000000000000000000000000
0000111100001111000011110000111100001111000011110000111100001111000011110000111100001111000011110000111100001111000011110000
0000111100001111000011110000111100001111000011110000111100001111000011110000111100001111000011110000111100001111000011110000
0000111100001111000011110000111100001111000011110000111100001111000011110000111100001111000011110000111100001111000011110000
0000111100001111000011110000111100001111000011110000111100001111000011110000111100001111000011110000111100001111000011110000
0000111100001111000011110000111100001111000011110000111100001111000011110000111100001111000011110000111100001111000011110000
0000111100001111000011110000111100001111000011110000111100001111000011110000111100001111000011110000111100001111000011110000
0000111100001111000011110000111100001111000011110000111100001111000011110000111100001111000011110000111100001111000011110000
0000111100001111000011110000111100001111000011110000111100001111000011110000111100001111000011110000111100001111000011110000
0000111100001111000011110000111100001111000011110000111100001111000011110000111100001111000011110000111100001111000011110000
0000111100001111000011110000111100001111000011110000111100001111000011110000111100001111000011110000111100001111000011110000
0000111100001111000011110000111100001111000011110000111100001111000011110000111100001111000011110000111100001111000011110000
0000111100001111000011110000111100001111000011110000111100001111000011110000111100001111000011110000111100001111000011110000
0000111100001111000011110000111100001111000011110000111100001111000011110000111100001111000011110000111100001111000011110000
0000111100001111000011110000111100001111000011110000111100001111000011110000111100001111000011110000111100001111000011110000
0000111100001111000011110000111100001111000011110000111100001111000011110000111100001111000011110000111100001111000011110000
0000111100001111000011110000111100001111000011110000111100001111000011110000111100001111000011110000111100001111000011110000
0000111100001111000011110000111100001111000011110000111100001111000011110000111100001111000011110000111100001111000011110000
0000111100001111000011110000111100001111000011110000111100001111000011110000111100001111000011110000111100001111000011110000
0000111100001111000011110000111100001111000011110000111100001111000011110000111100001111000011110000111100001111000011110000
0000111100001111000011110000111100001111000011110000111100001111000011110000111100001111000011110000111100001111000011110000
0000111100001111000011110000111100001111000011110000111100001111000011110000111100001111000011110000111100001111000011110000
0000111100001111000011110000111100001111000011110000111100001111000011110000111100001111000011110000111100001111000011110000
0000000000000000000000000000000000000000000000000000000000000000000000000000000000000000000000000000000000000000000000000000
0000000000000000000000000000000000000000000000000000000000000000000000000000000000000000000000000000000000000000000000000000
0000000000000000000000000000000000000000000000000000000000000000000000000000000000000000000000000000000000000000000000000000
0000000000000000000000000000000000000000000000000000000000000000000000000000000000000000000000000000000000000000000000000000
0000000000000000000000000000111100001111000011110000111100001111000011110000111100001111000011110000111100001111000011110000
0000000000000000000000000000111100001111000011110000111100001111000011110000111100001111000011110000111100001111000011110000
0000000000000000000000000000111100001111000011110000111100001111000011110000111100001111000011110000111100001111000011110000
0000000000000000000000000000111100001111000011110000111100001111000011110000111100001111000011110000111100001111000011110000
0000000000000000000000000000111100001111000011110000111100001111000011110000111100001111000011110000111100001111000011110000
0000000000000000000000000000111100001111000011110000111100001111000011110000111100001111000011110000111100001111000011110000
0000000000000000000000000000111100001111000011110000111100001111000011110000111100001111000011110000111100001111000011110000
0000000000000000000000000000111100001111000011110000111100001111000011110000111100001111000011110000111100001111000011110000
0000000000000000000000000000111100001111000011110000111100001111000011110000111100001111000011110000111100001111000011110000
0000000000000000000000000000111100001111000011110000111100001111000011110000111100001111000011110000111100001111000011110000
0000000000000000000000000000111100001111000011110000111100001111000011110000111100001111000011110000111100001111000011110000
0000000000000000000000000000111100001111000011110000111100001111000011110000111100001111000011110000111100001111000011110000
0000000000000000000000000000111100001111000011110000111100001111000011110000111100001111000011110000111100001111000011110000
0000000000000000000000000000111100001111000011110000111100001111000011110000111100001111000011110000111100001111000011110000
0000000000000000000000000000111100001111000011110000111100001111000011110000111100001111000011110000111100001111000011110000
0000000000000000000000000000111100001111000011110000111100001111000011110000111100001111000011110000111100001111000011110000
0000000000000000000000000000111100001111000011110000111100001111000011110000111100001111000011110000111100001111000011110000
0000000000000000000000000000111100001111000011110000111100001111000011110000111100001111000011110000111100001111000011110000
0000000000000000000000000000111100001111000011110000111100001111000011110000111100001111000011110000111100001111000011110000
0000000000000000000000000000111100001111000011110000111100001111000011110000111100001111000011110000111100001111000011110000
0000000000000000000000000000000000000000000000000000000000000000000000000000000000000000000000000000000000000000000000000000
0000000000000000000000000000000000000000000000000000000000000000000000000000000000000000000000000000000000000000000000000000
0000000000000000000000000000000000000000000000000000000000000000000000000000000000000000000000000000000000000000000000000000
0000000000000000000000000000000000000000000000000000000000000000000000000000000000000000000000000000000000000000000000000000
